#############
#....#o#..###
#.##*#.#...##
#.s........##
####o#*##*o##
####........#
#############
