 ######
 #...##
##...##
#.***.#
#sooo.#
#######
