#########
###..####
#..*o*.o#
#oo*s*.##
#o.o**.##
###..####
#########

