########
##...s##
##..#..#
##o..*.#
##.**#o#
####..o#
########

