#######
#..@..#
#.....#
##.#.##
##*so##
##...##
#######
