###########
####......#
####.###.##
#.*..o#...#
#.oo.*s.*.#
###########
