########
########
#o...o.#
#.#.#..#
#s*..*o#
#####.*#
#####..#
########
