########
#..o####
#.*oo.##
#..##*##
##..#..#
##*...s#
##..####
########
