     ####
######..#
#.......#
#..ooo.o#
##*######
#.*..####
#...*####
##..*..##
 ##.s..##
  #######


