#######
#.....#
#.***o#
##.#so#
 #.#.o#
 #..#.#
 ##...#
  #####


