######
#so###
#..###
#@...#
#..*.#
#..###
######
