      #####
      #o..#
      #o#.#
#######o#.#
#.s.*.*.*.#
#.#.#.#.###
#.......###
###########
