  ########
  #..#...#
  #..*...#
  #..##*##
####.##..#
#.sooo#*.#
#........#
######..##
     #####
