########
###..o.#
##.@.#.#
##.o*..#
##..#*##
###.s.##
########
########

