#####
#...####
#.#.o..#
#.#*o..#
#.s*@#.#
####...#
   #####
