 #####
 #...#
 #.o.#
##.@.#
#..@##
#..s##
##.*.#
 #...#
 #####
