###################
#####...###########
#####*..###########
#####..*###########
###..*.*.##########
###.#.##.##########
#...#.##.#####..oo#
#.*..*..........oo#
#####.###.#s##..oo#
#####.....#########
###################
