########
###o*..#
####.*o#
#.o..###
##*s.###
##..*.##
###.o.##
########

