###########
#........o#
#.###*##.##
#.......o##
#..##*#####
##o.....###
##..#*s.###
#.......###
###########
