  ######
####..##
#.*...##
#.*o*o.#
#.##o..#
#..s.###
########
