########
#.oo####
#.*....#
#..#*#.#
#.s.o*.#
########
########
########
