#####
##os#
##*.#
#...#
#o*.#
#####
