#######
#o..###
#.#.###
#.@*..#
#..*o.#
#..s###
#######
