 #########
 #....#..#
##.*#*#..#
#..o*os..#
#..o#....#
##########


