   ####
   #..#
   #s.#
####*o#
#...*o#
#.#.*o#
#....##
#######
