######
#ooo.#
#..*.#
#.#*##
#..*.#
#..s.#
######
