#######
#....##
#....##
##.**##
 #.*so#
 ##.oo#
  #####
