###########
#######...#
####.ooo#.#
####*...#.#
##..**###.#
##.s......#
###########
