 ######
##...##
#.o*o.#
#.*#*.#
#.o*o.#
#....##
##.s###
 ######
