#######
#...###
#..*..#
##@.o.#
 #...s#
 ######
