        #####
#########...#
#..###......#
#.oo..****..#
#.oo..#.s#..#
#############
