  ######
  #..###
  #s.###
  #..###
###.####
#....@.#
#..*...#
#####o.#
########
