########
#..#####
#....###
#..*@s.#
###.o#.#
  #....#
  ######


