 #####
 #...#
##.o.#
#..@.#
#.#.##
#..*.#
##.@.#
 #.s.#
 #####
