 #########
##.oooo###
#...######
#...*.*.s#
###..*.*.#
  ###....#
    ######


