########
####.s##
#..@*.##
#.....##
##.o####
##*.####
##.o####
########

