########
####.s##
####...#
#o.#**.#
#.....##
#o..*###
##o..###
########

